222222222222222222222222222222222222222222222
222222222222222222222222222222222222222222222
224400033004444000044430044440444000330004422
224400033004444400000333000000444000330004422
220000040000000000333333333344443333330000022
223300440003333000330000033300000300444400022
220000440003333044440000000300000304444433322
220000330004300000440000000044000000000033322
220000330004400000440333000000344000000030022
220033333304400030000333333333333000333330022
220000333304400330000333000000004444400000022
224444000334443333333333443300000444444000022
224444000334443333333333444330033333333333322
223333333330440000000034444430033330003444422
223444433300440004444430000000033044444344422
224444443300033333444430004444033000000034422
223334443000030003000000033333333000304444422
224433003000330000000000004440004440330000022
224433333000333333344330000444400000343300022
224444440004440034444334443333333000344300022
224444440000440030444334443344433000344300022
220000000003330030003333333344433333344300022
223330403003030000000000330004444403444400022
223333443003034444400000330000000003000000022
220000003444434444330444440003000003000333322
220000003444430000330000000003000033044400022
220033003333333333333333000033330030044400022
224443404034444444344433000444430030000000022
224443040430044444344440004444430033300034422
224443304030033334344440000003330003000034422
224443330030000433333300033330000003444434422
220033004444004400333333333330000003444434422
220033004400034400000000000034403333304433322
220000003000034444400000000034403443304400022
220444003003330444433303330034444444304404422
220443333003300033333666334433004000333344422
220003000444444000033666334430004000440400022
220003000444444000033666334430003004444400022
222222222222222222222222222222222222222222222
222222222222222222222222222222222222222222222
